20 20
35 28 28 28 28 28 28 28 28 28 28 28 28 28 28 28 28 28 28 34
30 26 26 26 26 26 26 26 26 26 26 26 26 26 26 26 26 26 26 31
30 0  0  0  0  0  0  0  0  0  0  0  0  0  0  0  0  0  0  31
30 0  0  0  0  0  0  0  0  0  0  0  0  0  0  0  0  0  0  31
30 0  0  0  0  0  0  0  0  0  0  0  0  0  0  0  0  0  0  31
30 0  0  0  0  0  0  0  0  0  0  0  0  0  0  0  0  0  0  31
30 0  0  0  0  0  0  0  0  0  0  0  0  0  0  0  0  0  0  31
30 0  0  0  0  0  0  0  0  0  0  0  0  0  0  0  0  0  0  31
30 0  0  0  0  0  0  0  0  0  0  0  0  0  0  0  0  0  0  31
30 0  0  0  0  0  0  0  0  0  0  0  0  0  0  0  0  0  0  31
30 0  0  0  0  0  0  0  0  0  0  0  0  0  0  0  0  0  0  31
30 0  0  0  0  0  0  0  0  0  0  0  0  0  0  0  0  0  0  31
30 0  0  0  0  0  0  0  0  0  0  0  0  0  0  0  0  0  0  31
30 0  0  0  0  0  0  0  0  0  0  0  0  0  0  0  0  0  0  31
30 0  0  0  0  0  0  0  0  0  0  0  0  0  0  0  0  0  0  31
30 0  0  0  0  0  0  0  0  0  0  0  0  0  0  0  0  0  0  31
30 0  0  0  0  0  0  0  0  0  0  0  0  0  0  0  0  0  0  31
30 0  0  0  0  0  0  0  0  0  0  0  0  0  0  0  0  0  0  31
30 0  0  0  0  0  0  0  0  0  0  0  0  0  0  0  0  0  0  31
33 29 29 29 29 29 29 29 29 29 29 29 29 29 29 29 29 29 29 32