26 24
32 28 28 28 28 28 28 28 28 28 28 28 28 28 28 28 28 28 28 28 28 28 28 28 28 33
30 26 26 26 26 36 26 26 26 26 26 26 26 26 26 26 36 26 26 26 26 26 26 26 26 31
30 27 27 27 27 36 27 27 27 27 27 27 27 27 27 27 36 27 27 27 27 27 27 27 27 31
30 29 29 29 29 36 0  0  0  0  0  0  0  0  0  0  36 0  0  0  0  0  0  0  0  31
30 10 11 11 12 36 0  0  0  0  0  0  0  0  0  0  36 0  0  0  0  0  0  0  0  31
30 10 11 11 12 36 0  0  0  0  0  0  0  0  0  0  36 0  0  0  0  0  0  0  0  31
30 10 11 11 12 36 0  0  0  0  0  0  0  0  0  0  36 0  0  0  0  0  0  0  0  31
30 10 11 11 12 36 0  0  0  0  0  0  0  0  0  0  36 0  0  0  0  0  0  0  0  31
30 13 14 14 15 36 0  0  0  0  0  0  0  0  0  0  36 0  0  0  0  0  0  0  0  31
30 37 40 0  41 37 37 37 37 37 37 40 0  41 37 37 37 37 37 40 0  41 37 37 37 31
30 26 26 0  26 26 26 26 26 26 26 26 0  26 26 26 26 26 26 26 0  26 26 26 26 31
30 27 27 0  27 27 27 27 27 27 27 27 0  27 27 27 27 27 27 27 0  27 27 27 27 31
30 0  0  0  0  0  0  0  0  0  0  0  0  0  0  0  0  0  0  0  0  0  0  0  0  31
30 0  0  0  0  0  0  0  0  0  0  0  0  0  0  0  0  0  0  0  0  0  0  0  0  31
30 0  0  0  0  0  0  0  0  0  0  0  0  0  0  0  0  0  0  0  0  0  0  0  0  31
30 37 37 37 37 37 37 37 37 37 37 37 37 43 0  0  0  0  0  0  0  0  0  0  0  31
30 26 26 26 26 26 26 26 26 26 26 26 26 36 0  0  0  0  0  0  0  0  0  0  0  31
30 27 27 27 27 27 27 27 27 27 27 27 27 38 0  0  0  42 37 37 37 37 37 37 37 31
30 0  0  0  0  0  0  0  0  0  0  0  0  26 0  0  0  38 26 26 26 26 26 26 26 31
30 0  0  0  0  0  0  0  0  0  0  0  0  27 0  0  0  26 27 27 27 27 27 27 27 31
30 0  0  0  0  0  0  0  0  0  0  0  0  0  0  0  0  27 0  0  0  0  0  0  0  31
30 0  0  0  0  0  0  0  0  0  0  0  0  39 0  0  0  0  0  0  0  0  0  0  0  31
30 0  0  0  0  0  0  0  0  0  0  0  0  36 0  0  0  39 0  0  0  0  0  0  0  31
34 29 29 29 29 29 29 29 29 29 29 29 29 29 29 29 29 29 29 29 29 29 29 29 29 35